########################################################################################################################################################################################################
#.................................................................................................###..................................................................................................#
#.................................................................................................###..................................................................................................#
#.................................................................................................###..................................................................................................#
#.................................................................................................###..................................................................................................#
#.................................................................................................###..................................................................................................#
#.................................................................................................###..................................................................................................#
#.................................................................................................###..................................................................................................#
#.................................................................................................###..................................................................................................#
#......................................................................................................................................................................................................#
#......................................................................................................................................................................................................#
#......................................................................................................................................................................................................#
#......................................................................................................................................................................................................#
#......................................................................................................................................................................................................#
#......................................................................................................................................................................................................#
#......................................................................................................................................................................................................#
#......................................................................................................................................................................................................#
#......................................................................................................................................................................................................#
#......................................................................................................................................................................................................#
#......................................................................................................................................................................................................#
#......................................................................................................................................................................................................#
#......................................................................................................................................................................................................#
#......................................................................................................................................................................................................#
#......................................................................................................................................................................................................#
#......................................................................................................................................................................................................#
#...............................##########################............................................................................######################...........................................#
#...............................##########################............................................................................######################...........................................#
#...............................##########################............................................................................######################...........................................#
#...............................##########################............................................................................######################...........................................#
#...............................##########################............................................................................######################...........................................#
#...............................##########################............................................................................######################...........................................#
#...............................##########################............................................................................######################...........................................#
#...............................##########################............................................................................######################...........................................#
#...............................##########################............................................................................######################...........................................#
#...............................##########################............................................................................######################...........................................#
#...............................##########################............................................................................######################...........................................#
#...............................##########################............................................................................######################...........................................#
#......................................................................................................................................................................................................#
#......................................................................................................................................................................................................#
#......................................................................................................................................................................................................#
#......................................................................................................................................................................................................#
#......................................................................................................................................................................................................#
#......................................................................................................................................................................................................#
#......................................................................................................................................................................................................#
#.................................................................................................###..................................................................................................#
#.................................................................................................###..................................................................................................#
#.................................................................................................###..................................................................................................#
#.................................................................................................###..................................................................................................#
###########..................................................................................################...............................................................................############
###########..................................................................................################...............................................................................############
#.................................................................................................###..................................................................................................#
#.................................................................................................###..................................................................................................#
#.................................................................................................###..................................................................................................#
#.................................................................................................###..................................................................................................#
#......................................................................................................................................................................................................#
#......................................................................................................................................................................................................#
#......................................................................................................................................................................................................#
#......................................................................................................................................................................................................#
#......................................................................................................................................................................................................#
#......................................................................................................................................................................................................#
#......................................................................................................................................................................................................#
#......................................................................................................................................................................................................#
#......................................................................................................................................................................................................#
#......................................................................................................................................................................................................#
#......................................................................................................................................................................................................#
#......................................................................................................................................................................................................#
#......................................................................................................................................................................................................#
#......................................................................................................................................................................................................#
#...............................##########################............................................................................######################...........................................#
#...............................##########################............................................................................######################...........................................#
#...............................##########################............................................................................######################...........................................#
#...............................##########################............................................................................######################...........................................#
#...............................##########################............................................................................######################...........................................#
#...............................##########################............................................................................######################...........................................#
#...............................##########################............................................................................######################...........................................#
#...............................##########################............................................................................######################...........................................#
#...............................##########################............................................................................######################...........................................#
#...............................##########################............................................................................######################...........................................#
#...............................##########################............................................................................######################...........................................#
#...............................##########################............................................................................######################...........................................#
#...............................##########################............................................................................######################...........................................#
#...............................##########################............................................................................######################...........................................#
#......................................................................................................................................................................................................#
#......................................................................................................................................................................................................#
#......................................................................................................................................................................................................#
#......................................................................................................................................................................................................#
#......................................................................................................................................................................................................#
#......................................................................................................................................................................................................#
#......................................................................................................................................................................................................#
#......................................................................................................................................................................................................#
#......................................................................................................................................................................................................#
#......................................................................................................................................................................................................#
#......................................................................................................................................................................................................#
#......................................................................................................................................................................................................#
#......................................................................................................................................................................................................#
#......................................................................................................................................................................................................#
#......................................................................................................................................................................................................#
#......................................................................................................................................................................................................#
#......................................................................................................................................................................................................#
########################################################################################################################################################################################################
