####################################################################################################
#.................................................###..............................................#
#.................................................###..............................................#
#.................................................###..............................................#
#.................................................###..............................................#
#.................................................###..............................................#
#.................................................###..............................................#
#.................................................###..............................................#
#.................................................###..............................................#
#.....................................############################.................................#
#.....................................############################.................................#
#.....................................############################.................................#
#.....................................############################.................................#
#.....................................############################.................................#
#.....................................############################.................................#
#.....................................############################.................................#
#.....................................############################.................................#
#.....................................############################.................................#
#.....................................############################.................................#
#.....................................############################.................................#
#.....................................############################.................................#
#..................................................................................................#
#..................................................................................................#
#..................................................................................................#
#..................................................................................................#
#..................................................................................................#
#..................................................................................................#
##############################.................................#####################################
##############################.................................#####################################
##############################.................................#####################################
#..............................................................###.................................#
#..............................................................###.................................#
#..............................................................###.................................#
#..............................................................###.................................#
##############################.................................#####################################
##############################.................................#####################################
##############################.................................#####################################
#..................................................................................................#
#..................................................................................................#
#..................................................................................................#
#..................................................................................................#
#..................................................................................................#
#..................................................................................................#
#..................................................................................................#
#..................................................................................................#
#..................................................................................................#
#..................................................................................................#
#..................................................................................................#
#..................................................................................................#
#..................................................................................................#
#..................................................................................................#
#..................................................................................................#
#..................................................................................................#
##############################.................................#####################################
##############################.................................#####################################
##############################.................................#####################################
#..................................................................................................#
#..................................................................................................#
#..................................................................................................#
#..................................................................................................#
#..................................................................................................#
#..................................................................................................#
#..................................................................................................#
#..................................................................................................#
#..................................................................................................#
#..................................................................................................#
#......................................###.........................................................#
#......................................###.........................................................#
#......................................###.........................................................#
#......................................###.........................................................#
#......................................###.........................................................#
#......................................###.........................................................#
#......................................###.........................................................#
#......................................###.........................................................#
##########################################.....................#####################################
##########################################.....................#####################################
##########################################.....................#####################################
#......................................###.........................................................#
#......................................###.........................................................#
#......................................###.........................................................#
#......................................###.........................................................#
#......................................###.........................................................#
#......................................###.........................................................#
#......................................###.........................................................#
#......................................###.........................................................#
#......................................###.........................................................#
#......................................###.........................................................#
#......................................###.........................................................#
#......................................###.........................................................#
#..................................................................................................#
#..................................................................................................#
#..................................................................................................#
#..................................................................................................#
#..................................................................................................#
#..................................................................................................#
#......................................###.........................................................#
#......................................###.........................................................#
#......................................###.........................................................#
#......................................###.........................................................#
####################################################################################################
