####################################################################################################
#...........................................####...................................................#
#...........................................####...................................................#
#...........................................####...................................................#
#..................................................................................................#
#..................................................................................................#
#...........................................####...................................................#
#...........................................####...................................................#
#...........................................####...................................................#
#........................#########################################.................................#
#........................#########################################.................................#
#........................#########################################.................................#
#........................#########################################.................................#
#........................#########################################.................................#
#........................#########################################.................................#
#........................#########################################.................................#
#........................#########################################.................................#
#........................#########################################.................................#
#........................#########################################.................................#
#........................#########################################.................................#
#........................#########################################.................................#
#........................#########################################.................................#
#........................#########################################.................................#
#........................#########################################.................................#
#........................#########################################.................................#
#........................#########################################.................................#
#........................#########################################.................................#
#........................#########################################.................................#
#........................#########################################.................................#
#........................#########################################.................................#
#........................#########################################.................................#
#........................#########################################.................................#
#........................#########################################.................................#
#........................#########################################.................................#
#........................#########################################.................................#
#........................#########################################.................................#
#........................#########################################.................................#
#........................#########################################.................................#
#..................................................................................................#
#..................................................................................................#
#..................................................................................................#
#..................................................................................................#
#..................................................................................................#
#..................................................................................................#
#..................................................................................................#
#..................................................................................................#
#..................................................................................................#
#..................................................................................................#
#..................................................................................................#
#..................................................................................................#
#..................................................................................................#
#..................................................................................................#
##############################................................######################################
##############################................................######################################
##############################................................######################################
##############################................................######################################
##############################................................######################################
#..................................................................................................#
#..................................................................................................#
#..................................................................................................#
#..................................................................................................#
#..................................................................................................#
#..................................................................................................#
#..................................................................................................#
#..................................................................................................#
#..................................................................................................#
#..................................................................................................#
#........................#########################################.................................#
#........................#########################################.................................#
#........................#########################################.................................#
#........................#########################################.................................#
#........................#########################################.................................#
#........................#########################################.................................#
#........................#########################################.................................#
#........................#########################################.................................#
#........................#########################################.................................#
#........................#########################################.................................#
#........................#########################################.................................#
#........................#########################################.................................#
#........................#########################################.................................#
#........................#########################################.................................#
#........................#########################################.................................#
#........................#########################################.................................#
#........................#########################################.................................#
#........................#########################################.................................#
#........................#########################################.................................#
#........................#########################################.................................#
#........................#########################################.................................#
#........................#########################################.................................#
#...........................................####...................................................#
#...........................................####...................................................#
#...........................................####...................................................#
#...........................................####...................................................#
#..................................................................................................#
#..................................................................................................#
#...........................................####...................................................#
#...........................................####...................................................#
#...........................................####...................................................#
#...........................................####...................................................#
####################################################################################################
